words count: 743
nicely - мило
common - общий
humanreadable - человек читаемый
across - через
holy - святой
stretch - потягиваться
earlier - ранее
divides - делит
note - примечание
downside - обратная сторона
mean - иметь в виду
personally - лично
objectoriented - объектно-ориентированный
think - думать
find - находить
pretty - симпатичный
functions - функции
understanding - понимание
other - другой
comprehension - понимание
iterating - итерация
implement - осуществлять
length - длина
greatest - величайший
giving - предоставление
communicate - общаться
next - следующий
occasionally - изредка
cool - прохладный
testing - тестирование
square - квадрат
tuned - настроенный
quick - быстрый
structure - состав
gets - получает
compare - сравнивать
formatting - форматирование
italian - итальянский
exactly - точно
however - однако
append - добавить
session - сессия
care - Забота
encourage - поощрять
gnarly - корявый
limitations - ограничения
collection - коллекция
programming - программирование
with - с
contains - содержит
jump - Прыгать
explain - объяснять
called - называется
walk - ходить
through - через
total - общий
representation - представление
operation - операция
come - приходить
example - пример
quickly - быстро
standard - стандартный
look - смотреть
datetime - дата и время
case - случай
idea - идея
recommend - рекомендовать
kind - добрый
introduce - представлять
exists - существует
writing - письмо
creating - создание
minute - минута
longer - дольше
conflict - конфликт
screwed - облажался
helps - помогает
consumption - потребление
helper - помощник
theoretical - теоретический
still - все еще
balance - баланс
today - сегодня
date - дата
description - описание
someone - кто-то
doing - делает
wrong - неправильный
address - адрес
repr - представитель
couple - пара
meant - имел в виду
access - доступ
needs - потребности
three - три
convert - конвертировать
programs - программы
classical - классический
gives - дает
string - нить
extremely - очень сильно
print - Распечатать
explains - объясняет
quite - довольно
always - всегда
comprehensions - понимания
toolbox - ящик для инструментов
opaque - непрозрачный
which - который
reason - причина
type - тип
represent - представлять
become - становиться
library - библиотека
import - Импортировать
break - перерыв
similar - похожий
kick - пинать
scenes - сцены
some - некоторый
classic - классический
existing - существующий
tell - рассказывать
pythonic - пифонический
something - что-нибудь
structured - структурированный
communication - коммуникация
worry - волноваться
later - позже
dunder - гром
understand - понимать
without - без
learn - учиться
create - создавать
practices - практики
them - их
soon - скоро
unambiguous - однозначный
cpython - cpython
trick - обманывать
hopefully - с надеждой
easytoread - легко читаемый
staticmethod - статический метод
hurt - повредить
actual - действительный
hitting - удар
communicating - общение
maybe - может быть
fashion - мода
includes - включает
numbers - цифры
they - они
first - первый
watching - наблюдаю
getting - получающий
guess - предполагать
redefined - переопределено
clear - прозрачный
filtered - фильтрованный
factory - фабрика
just - только
spilling - проливание
hard - жесткий
filtering - фильтрация
initial - исходный
looked - смотрел
terms - условия
caveat - предостережение
paste - вставить
terse - краткий
limitation - ограничение
really - Действительно
classmethod - метод класса
empty - пустой
meters - метры
calculating - расчет
already - уже
replaced - заменены
builtin - встроенный
rerun - повторный показ
range - диапазон
mushrooms - грибы
there - там
depending - в зависимости
teach - учат
slightly - немного
handson - руки вверх
directions - направления
ahead - предстоящий
unit - единица
within - в пределах
point - точка
because - потому что
these - эти
whole - весь
takes - берет
shorthand - стенография
types - типы
limit - предел
rest - отдых
below - ниже
than - чем
representations - представления
changed - измененный
past - прошлое
operator - оператор
transformed - преобразованный
number - число
implementations - реализации
regular - обычный
magical - волшебный
output - выход
version - версия
hint - намекать
recap - резюме
variable - переменная
sort - Сортировать
cleaner - очиститель
overusing - злоупотребление
simplified - упрощенный
appending - добавление
happen - случаться
warning - предупреждение
explicit - явный
containers - контейнеры
parts - части
elaborate - разрабатывать
assume - предполагать
this - этот
team - команда
mark - отметка
teaching - преподавание
wrapped - завернутый
tempting - заманчиво
arcane - тайный
cases - случаи
tired - усталый
confusing - сбивающий с толку
assigned - назначенный
from - от
sake - ради
workaround - обходной путь
kinds - виды
mention - упомянуть
give - давать
detail - деталь
copied - скопирован
concept - концепция
your - твой
actually - на самом деле
retype - перепечатать
take - брать
better - лучше
opinion - мнение
interact - взаимодействовать
audience - аудитория
generate - генерировать
recreate - воссоздать
itself - сам
more - более
solve - решать
scheme - схема
means - означает
advantage - преимущество
modified - модифицированный
usually - обычно
directly - напрямую
applied - применяемый
took - взял
control - контроль
fairly - весьма
true - истинный
goes - идет
display - отображать
over - над
myclass - мои занятия
examples - Примеры
uses - использует
complex - сложный
iterate - повторять
instantiate - создавать экземпляр
populated - населенный
prosciutto - прошутто
plain - простой
danger - Опасность
strange - странный
help - помощь
maintain - поддерживать
stuff - вещи
steps - шаги
loop - петля
gone - ушел
work - работа
applies - применяется
second - второй
nice - хороший
forgot - забыл
side - сторона
everything - все
giant - гигант
tests - тесты
calculation - расчет
integers - целые числа
long - длинный
offloading - разгрузка
nevertheless - тем не менее
simplifies - упрощает
complicated - сложный
anyway - в любом случае
default - по умолчанию
little - маленький
spend - тратить
benefits - преимущества
horrible - ужасный
then - затем
could - мог
feature - особенность
decorator - декоратор
computing - вычисления
execute - выполнять
else - еще
came - пришел
whatever - что бы ни
when - когда
dummy - дурачок
start - начинать
provide - предоставлять
world - мир
implementation - выполнение
people - люди
potentially - потенциально
contain - содержать
deep - глубокий
maintainable - ремонтопригодный
margherita - Маргарита
here - здесь
nested - вложенный
integer - целое число
should - должен
attributes - атрибуты
list - список
flag - флаг
done - сделанный
arguments - аргументы
works - работает
format - формат
function - функция
under - под
seems - кажется
down - вниз
yourself - сам
minimum - минимум
documentation - документация
practice - упражняться
pythoning - питонирование
double - двойной
most - большинство
finish - заканчивать
state - состояние
talked - говорили
filter - фильтр
space - космос
community - сообщество
also - также
general - общий
wrap - сворачивать
principles - принципы
result - результат
highly - высоко
probably - вероятно
magic - магия
interface - интерфейс
move - двигаться
reach - достигать
core - основной
instantiating - создание экземпляра
circle - круг
global - Глобальный
seeing - видя
separate - отдельный
manually - вручную
pizza - пицца
spelling - написание
correct - правильный
where - где
time - время
analogy - аналогия
brackets - кронштейны
differently - иначе
once - один раз
conventions - конвенции
going - идущий
reads - читает
populate - заселять
constant - постоянный
readability - читабельность
line - линия
public - общественный
keeping - сохранение
init - в этом
single - одинокий
form - форма
reading - чтение
user - пользователь
instead - вместо
simple - простой
honest - честный
honestly - честно
careful - осторожный
printing - печать
apart - отдельно
somewhat - в некотором роде
loops - петли
included - включено
oneliner - один лайнер
things - вещи
literally - буквально
remainder - остаток
interesting - интересный
copying - копирование
mistaken - ошибочный
defined - определенный
like - нравиться
console - консоль
definitely - определенно
happy - счастливый
sucks - отстой
selfcontained - автономный
small - маленький
sure - конечно
original - оригинальный
those - те
affects - влияет
building - здание
developer - разработчик
self - себя
build - строить
specific - специфический
evaluating - оценивая
strings - струны
becomes - становится
convention - соглашение
pointing - указывая
overly - чрезмерно
often - часто
nesting - гнездование
scenarios - сценарии
readable - удобочитаемый
show - показывать
have - иметь
does - делает
developers - Разработчики
program - программа
yada - яда
amozzarella - моцарелла
automatically - автоматически
modifying - модификация
mind - разум
about - о
updating - обновление
away - прочь
method - метод
ways - способы
constructor - конструктор
course - курс
refer - ссылаться
code - код
helpful - полезный
value - ценить
between - между
question - вопрос
make - делать
well - хорошо
pattern - шаблон
thing - вещь
enough - достаточно
react - реагировать
individually - индивидуально
overwhelming - подавляющий
calculate - вычислить
object - объект
previous - предыдущий
mainly - в основном
methods - методы
need - нуждаться
super - супер
namespace - пространство имен
takeaway - еда на вынос
leave - оставлять
word - слово
reacts - реагирует
returning - возвращение
into - в
again - снова
whether - ли
shortened - сокращенный
order - заказ
favorite - любимый
remember - помнить
feel - чувствовать
different - другой
modulo - по модулю
completely - полностью
interview - интервью
created - созданный
simplistic - упрощенный
fail - неудача
around - вокруг
markers - маркеры
signal - сигнал
looks - выглядит
static - статический
problem - проблема
condition - состояние
transformation - трансформация
awesome - потрясающий
pasting - вставка
exploring - исследование
perfect - идеальный
calls - звонки
experiment - эксперимент
points - точки
hand - рука
able - способный
their - их
calling - звоню
falls - падает
money - деньги
printed - напечатанный
interpreter - устный переводчик
human - человек
very - очень
turn - повернуть
attain - по меньшей мере
values - ценности
approach - подход
basically - по сути
easy - легкий
taking - принимая
along - вдоль
concise - краткий
each - каждый
represented - представленный
added - добавлен
equivalent - эквивалент
realworld - реальный мир
adding - добавление
objects - объекты
lines - линии
been - был
want - хотеть
define - определять
characters - персонажи
inside - внутри
dictionary - словарь
align - выровнять
returns - возвращает
another - другой
updated - обновлено
hope - надеяться
area - область
same - такой же
name - имя
stretching - растягивание
module - модуль
memory - Память
talk - разговаривать
inspecting - проверка
call - вызов
part - часть
makes - делает
grail - Грааль
difference - разница
initialized - инициализирован
experimentation - экспериментирование
beneficial - выгодный
tutorial - руководство
differences - различия
link - связь
close - закрывать
unsatisfying - неудовлетворительный
internal - внутренний
improving - улучшение
inspect - осмотреть
class - сорт
divide - разделять
calculated - рассчитанный
whereas - тогда как
blasting - взрывные работы
what - что
debug - отлаживать
wonderful - замечательный
taken - взятый
might - мощь
exact - точный
right - верно
generalize - обобщать
representing - представляющий
squares - квадраты
much - много
crazier - безумнее
making - изготовление
great - большой
argue - спорить
independent - независимый
parameter - параметр
wondering - интересный
only - только
internally - внутренне
behind - позади
clearly - четко
child - ребенок
tells - рассказывает
recommendation - рекомендация
crazy - сумасшедший
sidetrack - отводить в сторону
refactoring - рефакторинг
text - текст
distinction - различие
flexible - гибкий
struggling - столкнувшийся с трудностями
mileage - пробег
least - наименее
bunch - связка
controlling - контроль
expression - выражение
return - возвращаться
clean - чистый
head - голова
powerful - мощный
stay - оставаться
underscore - нижнее подчеркивание
italians - итальянцы
supposed - предполагаемый
possible - возможный
inspected - проверено
even - даже
bottom - нижний
screen - экран
bring - приносить
place - место
read - читать
write - писать
using - с использованием
argument - аргумент
slight - легкий
radius - радиус
okay - хорошо
copy - копировать
users - пользователи
change - изменять
ease - простота
used - использовал
color - цвет
before - до
changing - изменение
stepbystep - шаг за шагом
learned - научился
easier - Полегче
pizzas - пицца
demystify - демистифицировать
include - включать
correspond - вести переписку
runs - бежит
cheese - сыр
formula - формула
ingredients - ингредиенты
update - обновлять
transform - трансформировать
naming - мы
preexisting - ранее существовавший
classes - занятия
real - настоящий
named - названный
seen - видимый
matter - иметь значение
based - основанный на
good - хороший
sense - смысл
nothing - ничего
video - видео
having - имея
immediately - немедленно
circumstances - обстоятельства
best - лучший
goal - цель
both - оба
expand - расширять
intent - намерение
generated - созданный
force - сила
skeleton - скелет
marks - Метки
complete - полный
features - функции
swap - менять
arbitrary - произвольный
relatively - относительно
helpers - помощники
previously - ранее
modify - изменить
forks - вилки
whenever - в любое время
keep - держать
surprising - удивительно
seem - казаться
fine - отлично
said - сказал
running - бег
solution - решение
boundary - граница
pass - проходить
know - знать
valid - действительный
deal - иметь дело
constructors - конструкторы
instance - пример
familiar - привычный
sensible - разумный
useful - полезный
working - работающий
that - что
showed - показал
handles - ручки
container - контейнер
back - назад
cleanly - чисто
defining - определение
would - бы
syntax - синтаксис
template - шаблон
tool - инструмент
wanted - в розыске
necessarily - обязательно
breakpoints - контрольные точки
particular - особый
apply - применять
answer - отвечать
future - будущее
python - питон
popular - популярный
happens - случается
